정제: 거기 비쌀까요??	거기 비쌀까요??
정제: 33만원	33만원
정제: 여기는17마넝	여기는 17만원
정제: 밑에가 훨 싸네요	밑에가 훨씬 싸네요.
정제: 저기도 가깝지 않아요!!	저기도 가깝지 않아요!!
정제: 하루 17만원 인거죠?	하루 17만 원인 거죠?
정제: 밑에꺼 해욧!!	밑에 꺼 해요!!
정제: 응응 두번째보다는 멀지망 가까운편	응응, 두 번째보다는 멀지만 가까운 편.
정제: 오키	오케이
정제: 두근두근해요	두근두근해요.
정제: Durls여긴별론가위치가??	Durls 여긴 별로인가 위치가??
정제: 시설이 여기가 더 좋다구하가지구	시설이 여기가 더 좋다고 해가지고.
정제: 오진짜요?	오, 진짜요?
정제: 얼마 차이도 안나는데 괜찮을거 같아요	얼마 차이도 안 나는데 괜찮을 거 같아요.
정제: 나 결저앻ㅆ어	나 결제했어
정제: 모를?	뭐를?
정제: 나 요번달에 돈 남으면	나 요번 달에 돈 남으면
정제: 현질할꺼야	현질 할 거야
정제: 우와	우와.
정제: 뭐 사게?	뭐 살까요?
정제: 이걸루	이걸로
정제: 나도 이걸루 사고싶어 ㅠㅠㅠ	나도 이걸로 사고 싶어 ㅠㅠㅠ.
정제: 근데 일단 공작마리드?	근데 일단 공작 마리드?
정제: 안나오면	안 나오면
정제: 다음시즌 버틴다	다음 시즌 버틴다.
정제: 존버존버	존버 존버.
정제: 황금 마차.그것두	황금 마차. 그것도
정제: 난 이걸루...	난 이걸로...
정제: 존버존버	존버 존버
정제: 너도 마리드 안나오면 포기햇	너도 마리드 안 나오면 포기했어.
정제: 그거 사ㄱ 봉황?	그거 사 봉황?
정제: 엉엉	어어
정제: ㅠㅠ	ㅠㅠ
정제: 베라드실?	베라드 실?
정제: 3000원 할인하는ㄷ	3000원 할인하는데.
정제: 얼만디	얼만데.
정제: 정가에서	정거에서
정제: 3천원빼면됌	3천 원 빼면 됨.
정제: 베달?	베달?
정제: 배달비무료	배달비 무료
정제: 배달?	배달?
정제: ㅇㅇ	응응
정제: 나 버즈 케이스	나 버즈 케이스.
정제: 엉	어
정제: 맘에 안드는걸사면	맘에 안 들면 걸 사면.
정제: 나중에 또 사고 또 사는	나중에 또 사고 또 사는.
정제: 지옥에 갇힐까	지옥에 갇힐까.
정제: 사실 마음에 드는거 사도 사고 또 사고 그래,,,,,,,	사실 마음에 드는 거 사도 사고 또 사고 그래,,,,,,,
정제: 지금 이거 가격의 메리트 못참는즁	지금 이거 가격의 메리트 못 참는 중.
정제: 근데 디즈니 케이스 못생겻서	근데 디즈니 케이스 못생겼어.
정제: 응...나도 알아 ㅠ	응... 나도 알아 ㅠ.
정제: 그냥 그 돈 아껴서 더 예쁜거 사라	그냥 그 돈 아껴서 더 예쁜 거 사라.
정제: 메탈파우더를 삿읍니다	메탈파우더를 샀습니다.
정제: 니 왜새 왜 네일에 꽂혔어??	니 왜 네일에 꽂혔어??
정제: ㅋㅋㅋㅋㅋㅋㅋㅋ	ㅋㅋㅋㅋㅋㅋㅋㅋ
정제: 아니	아니
정제: 양손을해야지	양손을 해야지
정제: 왜자꾸한손만하냐고	왜 자꾸 한손만 하냐고.
정제: ㅋㅋ	ㅋㅋ
정제: ㅋㅋㅋㅋ오호라 사쓰다가	ㅋㅋㅋㅋ 오호라 사서 쓰다가
정제: 그래 ㅋㅋㅋㅋ	그래 ㅋㅋㅋㅋ.
정제: 유튜브를 봤는데	유튜브를 봤는데
정제: 왠지 할수 있을거 같두라고	왠지 할 수 있을 거 같더라고.
정제: 그치맘 개 어렵다	그치만 개 어렵다.
정제: #@URL#	#@URL#
정제: 이거 하나 추가했어	이거 하나 추가했어.
정제: 혹시몰라서 2개 샀어	혹시 몰라서 2개 샀어.
정제: #@이름# 혹시 에코백 있뉘?	#@이름# 혹시 에코백 있니?
정제: 아뉘아뉭	아니아니
정제: 덥지 않나?	덥지 않나?
정제: 저건 완전 겨울용이야	저건 완전 겨울용이야.
정제: 겨울에	겨울에
정제: 축구할떄	축구할 때
정제: 너무 추워서	너무 추워서.
정제: 세일할떄 미리 샀어	세일할 때 미리 샀어.
정제: 아아	아아.
정제: #@이름#축구하러 가니?	#@이름# 축구하러 가니?
정제: 냐슈	냐슈.
정제: 야수	야수.
정제: 한국투자는 2천원의 청약 수수료가 붙는댕	한국투자는 2천원의 청약 수수료가 붙는대.
정제: 한국투자랑 농협에서 해야지	한국투자랑 농협에서 해야지.
정제: 건당이야??	건당이야??
정제: 청약 1건당??	청약 1건당?
정제: 응	응
정제: ㅜㅜㅜㅜㅜ이따가전화해보자ㅠㅠㅠㅠ	ㅜㅜㅜㅜㅜ이따가 전화해보자ㅠㅠㅠㅠ.
정제: #@이모티콘# 이제야 올린 나시인데 저따구면 어떡해야하지	#@이모티콘# 이제야 올린 나시인데 저따구면 어떡해야 하지.
정제: ㅠㅠㅠㅠㅠㅠ생각도못한 변수가 너무많다무서어	ㅠㅠㅠㅠㅠㅠ 생각도 못한 변수가 너무 많다 무서워.
정제: ㅜㅜㅜㅜㅜ	ㅜㅜㅜㅜㅜ
정제: #@이모티콘# 친구꺼 오늘 배송 안되겠다...	#@이모티콘# 친구꺼 오늘 배송 안 되겠다...
정제: 어쩌면좋아ㅠㅠㅠㅠ대체왜그러는거지ㅜㅜㅜㅜㅜㅜㅜㅜ	어쩌면 좋아ㅠㅠㅠㅠ 대체 왜 그러는 거지ㅜㅜㅜㅜㅜㅜㅜㅜ.
정제: ㅜㅜㅜㅜㅜㅜㅜ우리아무것도잘못한거없는데	ㅠㅠㅠㅠㅠㅠㅠ 우리 아무것도 잘못한 거 없는데
정제: ㅠㅠㅠ	ㅠㅠㅠ
정제: #@이모티콘# 너무 무서워	#@이모티콘# 너무 무서워.
정제: #@이모티콘# 신입이 얼굴 안비추고 사입삼촌 써서 문제인건가	#@이모티콘# 신입이 얼굴 안 비추고 사입 삼촌 써서 문제인 건가.
정제: #@이모티콘# 지금은전화도안받을테고 우째	이모티콘 지금은 전화도 안 받을 테고 어쩌지.
정제: 아나	아나.
정제: 정말그거라면	정말 그거라면.
정제: 별걸다갖고지랄이다	별 걸 다 갖고 지랄이다.
정제: #@이모티콘# 어쩌면 좋아	#@이모티콘# 어쩌면 좋아.
정제: #@이모티콘# 이따가같이전화해보자	#@이모티콘# 이따가 같이 전화해보자.
정제: #@이모티콘# (덜덜)	#@이모티콘# (덜덜)
정제: #@이름#을 이기고싶다	#@이름#을 이기고 싶다.
정제: ㅋㅋㅋㅋㅋㅋㅋㅋㅋㅋㅋㅋㅋ	ㅋㅋㅋㅋㅋㅋㅋㅋㅋㅋㅋㅋㅋ
정제: 더 인터넷서핑에 정진해야겠다	더 인터넷 서핑에 정진해야겠다.
정제: #@이모티콘#	#@이모티콘#
정제: ㅋㅋㅋㅋㅋ아니 걔는	ㅋㅋㅋㅋㅋ 아니 걔는.
정제: 내 전자기기를 책임지고잇어서	내 전자기기를 책임지고 있어서
정제: 그런거 다 대답해주거 다 해주거그래서	그런 거 다 대답해주고 다 해주기 그래서.
정제: 척척박사야	척척 박사야.
정제: ㅁㅎ기탈출ㅋㅋㅋㅋㅋ	ㅁㅎ 기탈출 ㅋㅋㅋㅋㅋㅋ
정제: 그 파트도 좀 더 공부해야겟군	그 파트도 좀 더 공부해야겠군.
정제: 전자기기 신제품 나오면 유튜브 리뷰 찾아보긴하는데	전자기기 신제품 나오면 유튜브 리뷰 찾아보긴 하는데.
정제: 핸드폰쪽에 좀 집중되어있긴하지..	핸드폰 쪽에 좀 집중되어 있긴 하지..
정제: 그마저도 내가 폰 바꾸고 난 이후엔 좀 시들해졌어	그마저도 내가 폰 바꾸고 난 이후엔 좀 시들해졌어.
정제: 드디어 돌아오는 목요일에 일본간당 크아아앙	드디어 돌아오는 목요일에 일본 간다 크아아앙.
정제: #@이름# 키스미 롱앤컬만 사다주면돼?	#@이름# 키스미 롱앤컬만 사다주면 돼?
정제: 한개?	한 개?
정제: 한개라니....	한 개라니....
정제: 모르겟어	모르겠어
정제: ㅋㅋㅋㅋ욕심나는데	ㅋㅋㅋㅋ 욕심나는데.
정제: 욕심내지말아야지...	욕심 내지 말아야지...
정제: 편의점 쇼핑하고옴	편의점 쇼핑하고 왔어
정제: 헐	헐
정제: 밀크타라멜	밀크카라멜
정제: #@이름#가	#@이름# 가
정제: 좋아해	좋아해.
정제: 상큼한 젤리 살지	상큼한 젤리 사지.
정제: 난 그것도 너무 좋아ㅠ시간떼우기 딱이다	난 그것도 너무 좋아ㅠ 시간 떼우기 딱이다.
정제: 나 젤리는	나 젤리는
정제: ㅋㅋㅋㅋㅋㅋㅋㅋㅋㅋㅋㅋㅋㅋㅋㅋㅋㅋㅋㅋ	ㅋㅋㅋㅋㅋㅋㅋㅋㅋㅋㅋㅋㅋㅋㅋㅋㅋㅋㅋㅋ
정제: 좋아한다	좋아한다
정제: 넹넹	네네.
정제: 60-70 정도 생각했는데 70~80이겠어	60-70 정도 생각했는데 70~80 이겠어.
정제: 더 들어갈 수도 있고	더 들어갈 수도 있고.
정제: #@이름#랑도 이야기 해봐	#@이름#랑도 이야기 해봐.
정제: 응응 ㅋㅋ	응응 ㅋㅋ.
정제: 코타키나발루는 얼마나 들어?	코타키나발루는 얼마나 들어?
정제: 정말 안 아끼고 써도 60 좀 넘을 것 같아	정말 안 아끼고 써도 60 좀 넘을 것 같아.
정제: 호텔도 좋은 데야	호텔도 좋은 데야.
정제: 이틀은 4성, 하루는 5성	이틀은 4성, 하루는 5성
정제: 언니 #@이름#가 뉴욕 가고싶대	언니 #@이름# 가 뉴욕 가고 싶대.
정제: 혼내줘	혼내줘
정제: 근데 코타 5성 가격으로 홍콩에서 2성 갈 수 있겠어	근데 코타 5성 가격으로 홍콩에서 2성 갈 수 있겠어.
정제: ㅋㅋㅋㅋㅋㅋㅋㅋㅋㅋㅋㅋ	ㅋㅋㅋㅋㅋㅋㅋㅋㅋㅋㅋㅋ
정제: 이런 된장녀	이런 된장녀.
정제: 미쿡은 나중에 돈 벌어서 가라고 해	미쿡은 나중에 돈 벌어서 가라고 해.
정제: 너무 비싸	너무 비싸.
정제: 괜찮은데가 어디잇지	괜찮은데 가 어디 있지.
정제: 홍콩 만만하게 봤었는데	홍콩 만만하게 봤었는데.
정제: 내일 컴터로 좀 찾아볼게	내일 컴퓨터로 좀 찾아볼게.
정제: 성수기는 역시 달라	성수기는 역시 달라.
정제: ㅋㅋㅋㅋㅋ	ㅋㅋㅋㅋㅋ
정제: 컴백도못하고	컴백도 못하고
정제: 추석떄도	추석 때도
정제: 못올팔자	못 올 팔자
정제: 카겜즈 왜사냐	카겜즈 왜 사냐.
정제: 오딘떄매사냐	오딘 때문에 사냐
정제: 엔시소프트좀 사주라	엔시소프트 좀 사주라.
정제: 카겜즈 왠지 만원오를느낌이라 ㅋㅋ	카겜즈 왠지 만원 오를 느낌이라 ㅋㅋ.
정제: 엔씨 노답스	엔씨 노답스.
정제: 도쿄게임쇼에 리니지w 나온다니깐 그때 오르면 팔아라	도쿄 게임쇼에 리니지W 나온다니깐 그때 오르면 팔아라.
정제: ㅋㅋ 프레스티지 바이오로직스	ㅋㅋ 프레스티지 바이오로직스
정제: 탈출해야하나	탈출해야 하나.
정제: ㅋㅋㅋ 셀트 떨어지던디	ㅋㅋㅋ 셀트 떨어지던데.
정제: ㅋㅋ25만언일떄도 있었는디 ㅋㅋ	ㅋㅋ 25만 원일 때도 있었는데 ㅋㅋ
정제: 저점 밑으로는 안갈것같에서 만족중이다	저점 밑으로는 안 갈 것 같아서 만족 중이다.
정제: ㅋㅋㅋㅋㅋㅋ	ㅋㅋㅋㅋㅋㅋ
정제: 셀트는 진짜 30때팔려나보네	셀트는 진짜 30 때 팔려나 보네.
정제: 33까지도 본디	33까지도 본다
정제: 억울하자나	억울하잖아
정제: 난 셀트 32이상	난 셀트 32 이상
정제: 님 급전버려고 하시는데 옷사시면어쩨여ㅠㅠㅠ	님 급 전버려고 하시는데 옷 사시면 어째요 ㅠㅠㅠ
정제: ㅋㅋㅋㅋㅋ케	ㅋㅋㅋㅋㅋ 케
정제: 일단 실물보고 ㄱ	일단 실물 보고 ㄱ
정제: 사고싳어서 ㅋㅋㅋ	사고싶어서 ㅋㅋㅋ
정제: 트위드 손상없는지 체크	트위드 손상 없는지 체크
정제: 나 그래서 당근못지운다	나 그래서 당근 못 지운다.
정제: 레녹스 그릇 3개 5만원 오늘도	레녹스 그릇 3개 5만원 오늘도.
정제: 손이 벌벌떨렦다....	손이 벌벌 떨렸다....
정제: 하지만 참아따......대단한 나자신....ㅎ	하지만 참았다...... 대단한 나 자신.... ㅎ
정제: 님 알바 전화주시져	님 알바 전화 주시죠.
정제: 어디 마트갈거야?	어디 마트 갈 거야?
정제: 여긴 이마트가 젤 낫드라구	여긴 이마트가 젤 낫더라고.
정제: 그렇구만	그렇구만.
정제: 젤크고 피코크도 많아	제일 크고 피코크도 많아.
정제: 밀키트종류도 많구	밀키트 종류도 많고.
정제: 피코크 시카고 피자 맛있을까?	피코크 시카고 피자 맛있을까?
정제: 맛있데	맛있대
정제: 늘품절이더라	늘 품절이더라.
정제: 그럴듯	그럴듯
정제: 다른 맛이나 뭐 괜찮은 티백들도 사요 ㅎ	다른 맛이나 뭐 괜찮은 티백들도 사요 ㅎ.
정제: 골라가면서 먹게 ㅋㅋ	골라 가면서 먹게 ㅋㅋ.
정제: 오호 ㅎㅎㅎ	오호 ㅎㅎㅎ.
정제: 나쁘지 않았나보네 ㅋㅋ	나쁘지 않았나 보네 ㅋㅋ.
정제: 맛이 나니까 물 많이 마시고 있쥐 ㅎ	맛이 나니까 물 많이 마시고 있지 ㅎ
정제: 잘하고 있네 ㅋㅋㅋ	잘 하고 있네 ㅋㅋㅋ.
정제: 뭐가 맛있을지 한번 봐야겠댜	뭐가 맛있을지 한번 봐야겠다
정제: 너무 쓰고 그런거 말고	너무 쓰고 그런 거 말고.
정제: 무난하게 먹을 수 있는걸로 사요 ㅎ	무난하게 먹을 수 있는 걸로 사요 ㅎ.
정제: 알쓰 ! ㅎㅎ	알았어! ㅎㅎ
정제: ㅋㅋㅋㅋ니쓰레기봉지어디서사다줄거야	ㅋㅋㅋㅋ 니 쓰레기 봉지 어디서 사다줄 거야.
정제: 바쁘니	바쁘니.
정제: 씨유 ?	씨유?
정제: 왜?	왜?
정제: 몇개사올거야	몇 개 살 거야.
정제: 한개얼마야	한 개 얼마야.
정제: 몰라...	몰라...
정제: 옛날꺼	옛날 거
정제: 니50리터750원이라햇제	니 50리터 750원이라 했지.
정제: 응	응.
정제: ????가격정상이냐	???? 가격 정상이냐
정제: 저거 안에 가방 하나 더 들어있긴 함 ㅋㅋㅋ	저거 안에 가방 하나 더 들어있긴 함 ㅋㅋㅋ.
정제: 근데 투명 두 개 주는 건 좀 너무하넴	근데 투명 두 개 주는 건 좀 너무하네.
정제: #@시스템#검색#	#@시스템# 검색.
정제: 셀린느는 저 안에 가죽으로 된 작은 파우치 주거든 ㅋㅋ	셀린느는 저 안에 가죽으로 된 작은 파우치 주거든 ㅋㅋ.
정제: ㅋㅋㅋㅋㅋㅋㅋ힙스터면 유행따라 저거 투명백 유행할 때 들고 유행 지나면 안에 파우치만 쓰면 되니까 뭨ㅋㅋㅋㅋ	ㅋㅋㅋㅋㅋㅋㅋ힙스터면 유행 따라 저거 투명백 유행할 때 들고 유행 지나면 안에 파우치만 쓰면 되니까 뭐ㅋㅋㅋㅋ
정제: 근데 마르지엘라는 진짜 좀 돈 아깝넼ㅋㅋ	근데 마르지엘라는 진짜 좀 돈 아깝네 ㅋㅋ
정제: 유행할때만쓸액수가아닌데 ㅂㄷㅂㄷ	유행할 때만 쓸 액수가 아닌데 ㅂㄷㅂㄷ.
정제: 셀린느는 투명백이 7만원 파우치가 80이라고 생각하면 살만할듯 ㅋㅋㅋ	셀린느는 투명백이 7만원, 파우치가 80이라고 생각하면 살만할 듯 ㅋㅋㅋ.
정제: 파우치저거 쥐똥만할거아냐	파우치 저거 쥐 똥만 할 거 아냐.
정제: 명품쇼핑백이있다곤했지만이가격인줄	명품 쇼핑백이 있다고 했지만 이 가격인 줄.
정제: 셀린느 가방이 400정도니까	셀린느 가방이 400정도니까.
정제: 파우치 80이면 뭐...	파우치 80이면 뭐...
정제: 비닐봉다리...	비닐 봉다리...
정제: 오빠야한테 내 아이패드	오빠야, 내 아이패드.
정제: 30~40줏다고함 ㅎ	30~40 줬다고 함 ㅎ
정제: 그래서 짝퉁산걸로 오해하시는거아니가	그래서 짝퉁 산걸로 오해하시는 거 아닌가.
정제: 에어3	에어3
정제: 십일번가에서	십일번가에서
정제: 50만원에 팔던데	50만 원에 팔던데.
정제: ㅋㅋㅋㅋㅋㅋㅋㅋㅋㅋㅋㅋ	ㅋㅋㅋㅋㅋㅋㅋㅋㅋㅋㅋㅋ
정제: 몰라 슬마 알아보긋나~	몰라, 설마 알아보겠나~
정제: 마쟈~~ ㅋㅋㅋㅋㅋㅋㅋㅋㅋ	맞아~~ ㅋㅋㅋㅋㅋㅋㅋㅋㅋ
정제: 하... 이번달.. 뭔가 살거 많을듯..	하... 이번 달.. 뭔가 살 것 많을듯..
정제: 십일절 벌써	십일절 벌써.
정제: 털릿다ㅜㅜ	털렸다ㅜㅜ
정제: 뭐샀너 !	뭐 샀어!
정제: 나도 지금	나도 지금
정제: 십일번가랑 지마켓 들락날락 거니느즁	십일번가랑 지마켓 들락날락 거리는 중.
정제: 난 십일번가만 판다ㅜ	난 십일번가만 판다 ㅜ.
정제: #@이름#아	#@이름# 아.
정제: 택배 왔는데 이게 뭐냐	택배 왔는데 이게 뭐냐.
정제: 아 그거 뜯어봐봐	아 그거 뜯어 봐봐.
정제: 로에베 패딩 산거임	로에베 패딩 산 건데.
정제: 어때?	어때?
정제: 아직 안뜯어 봄	아직 안 뜯어 봄.
정제: 기다려바	기다려 봐
정제: ㅋㅋ예쁘다	ㅋㅋ예쁘다.
정제: 근데 빵빵하진 않네	근데 빵빵하진 않네.
정제: ㅋㅋ 길어?	ㅋㅋ 길어?
정제: 조금	조금
정제: #@URL#	#@URL#
정제: 여기가 좀 더 저렴한것 같기도 함	여기가 좀 더 저렴한 것 같기도 해.
정제: 요런거 하면됮않아?	이런 거 하면 되잖아?
정제: 응 마자 ㅋㅋ ㅋ	응 맞아 ㅋㅋ ㅋ
정제: 이건 1300	이건 1300.
정제: 1300원이네, 아까 저거 같은 링크는 1900원이엇느뎀	1300원이네, 아까 저거 같은 링크는 1900원이었는데.
정제: 그거는 글씨가 세워져잇는느낌	그거는 글씨가 세워져 있는 느낌
정제: 입체로	입체로
정제: 아	아
정제: 상의 2.2 하의 3.2	상의 2.2 하의 3.2
정제: 5.4네	5.4네
정제: 블프에 얼마엿더라	블프에 얼마였더라
정제: 만장 에브리웨어	만장 에브리웨어
정제: 너가 산건 베이직 트레이닝 세트라 다른건가봐	너가 산 건 베이직 트레이닝 세트라 다른 건가 봐.
정제: 2.25에 샀네 너	2.25에 샀네 너.
정제: 거의 같아보이는디	거의 같아 보이는데
정제: 다른거래	다른 거래
정제: 재질이 좀 다른가..?	재질이 좀 다른가..?
정제: 그런가봄...	그런가봐...
정제: 살꺼임..?	살 거임..?
정제: 고민되네..	고민되네.
정제: 5.4 ㅠㅠ 비싸..	5.4 ㅠㅠ 비싸..
정제: 아 나도 블프때 샀어야하는건데	아 나도 블프 때 샀어야 하는 건데.
정제: ㅋㅋㅋㅋㅋㅋㅋㅋ	ㅋㅋㅋㅋㅋㅋㅋㅋ
정제: 사실	사실
정제: 그렇게 비싼건아니지	그렇게 비싼 건 아니지.
정제: 위아래 세트 5.4ㅕㄴ	위아래 세트 5.4년
정제: 면	면
정제: 기본티좀사야되는데	기본 티 좀 사야 되는데.
정제: 어디서사냐	어디서 사냐.
정제: 진짜 그냥흰색티가없음	진짜 그냥 흰색 티가 없음.
정제: 다 누래져가지고	다 누래져가지고
정제: 브랜디	브랜디
정제: 근데 넘 금방 늘어나긴한데..	근데 넘 금방 늘어나긴 한데..
정제: 싼마이로다가..	싼마이로다가..
정제: 좀 사고버려야겠어	좀 사고 버려야겠어.
정제: 이번달엔 돈없으니깐	이번 달엔 돈 없으니깐.
정제: 담달에 월급받으면사야지..	다음 달에 월급 받으면 사야지..
정제: 그럼 내꺼까지 수량 +1	그럼 내 꺼까지 수량 +1
정제: 하나만 사주라	하나만 사줘라
정제: ㅇㅖ..?ㅋㅋㅋㅋㅋ	애..?ㅋㅋㅋㅋㅋ
정제: 그래..되게 애걸복걸하네	그래.. 되게 애걸복걸하네.
정제: 오예~잼짜넠ㅋㅋ	오예~ 재밌잖아ㅋㅋ
정제: 근데 나도 흰티 걍 싼맛에 샀는데 다늘어남..	근데 나도 흰 티 그냥 산 맛에 샀는데 다 늘어남..
정제: 얼마주고 샀어	얼마 주고 샀어
정제: 그래도 일단 나 흰색티가 없어서 뭐라도 사야될듯	그래도 일단 나 흰색 티가 없어서 뭐라도 사야 될 듯.
정제: 얼마드라 한장에 5900원인가 그랬어	얼마더라 한 장에 5900원인가 그랬어.
정제: 나는 오히려 지연 되는 것 때문에	나는 오히려 지연되는 것 때문에.
정제: 빨리 들어왔으면 좋겠다	빨리 들어왔으면 좋겠다.
정제: 자꾸 배달이라든지	자꾸 배달이라든지.
정제: 이런 걸로 돈을 쓴대	이런 걸로 돈을 쓴대.
정제: 돈이 나간대	돈이 나간대
정제: ㅋㅋㅋㅋㅋㅋㅋㅋㅋㅋㅋㅋㅋㅋㅋㅋㅋㅋㅋㅋㅋㅋㅋㅋㅋ	ㅋㅋㅋㅋㅋㅋㅋㅋㅋㅋㅋㅋㅋㅋㅋㅋㅋㅋㅋㅋㅋㅋㅋㅋㅋ
정제: 완전 맞잖아	완전 맞잖아.
정제: 개인리딩 아녀...?	개인 리딩 아냐...?
정제: 농산물 카페 그만해	농산물 카페 그만 해
정제: ㅋㅋㅋㅋㅋㅋㅋㅋㅋㅋㅋㅋㅋㅋㅋㅋ	ㅋㅋㅋㅋㅋㅋㅋㅋㅋㅋㅋㅋㅋㅋㅋㅋ
정제: 나 이번주에 안 그래도	나 이번 주에 안 그래도.
정제: 펜션 여행으로	펜션 여행으로
정제: 돈 나가잖아	돈 나가잖아.
정제: 수요일에 장봐서 갈 건데	수요일에 장 봐서 갈 건데.
정제: 아 너 이번주에 간댔지	아 너 이번 주에 간댔지.
정제: 나 이번주가 크리스마스인줄	나 이번 주가 크리스마스인 줄
정제: 나 그럼 다음주다	나 그럼 다음 주다.
정제: 알아서잘타고오겟지...	알아서 잘 타고 오겠지...
정제: ㅋㅋㅋㅋㅋㅋ표사는줄이어마어마했음..	ㅋㅋㅋㅋㅋㅋ 표사는 줄이 어마어마했음..
정제: 그거미리예약된다아냐	그거 미리 예약된다. 알아?
정제: 예약햇을거같은데ㅋㅋㅋㅋㅋㅋㅋ	예약했을 것 같은데 ㅋㅋㅋㅋㅋㅋㅋ
정제: 후밖에덥다	후 밖에 덥다.
정제: 날씨진짜오락가락하노ㅋㅋㅋㅋ	날씨 진짜 오락가락하노 ㅋㅋㅋㅋ
정제: 나는모둠조별활동을 위해 나간다.....	나는 모둠 조별 활동을 위해 나간다.....
정제: 우울해....	우울해....
정제: 그거내는미리예약했는데	그거 나는 미리 예약했는데.
정제: 어늘까지던가 예약자너무많아서	오늘까지던가 예약자 너무 많아서.
정제: 예약판매중지래 어제드가보니까	예약 판매 중지래 어제 들어가봤더니.
정제: 암튼어제표사는줄진짜와기겁함ㅋㅋㅋㅋㅋㅋ	암튼 어제 표 사는 줄 진짜 와 기겁함 ㅋㅋㅋㅋㅋㅋ
정제: 놀이공원 중에서도 완전 오래 걸리는 놀이기구급이었음ㅋㅋㅋㅋㅋㅋㅋㅋㅋㅋㅋㅋ	놀이공원 중에서도 완전 오래 걸리는 놀이기구급이었어 ㅋㅋㅋㅋㅋㅋㅋㅋㅋㅋㅋㅋ.
정제: 엥ㅋㅋㅋㅋㅋㅋㅋㅋㅋ오늘그래도저녁에논다메ㅋㅋㅋㅋㅋㅋㅋ	엥 ㅋㅋㅋ 오늘 그래도 저녁에 논다며 ㅋㅋㅋ
정제: 엥ㅋㅋㅋㅋㅋㅋㅋ	엥ㅋㅋㅋㅋㅋㅋㅋ
정제: 지금파스꾸지	지금 파스꾸지
정제: 약속5신데  우리아직까지 뭐제대로한게없음ㅋㅋㅋ	약속 5시인데 우리 아직까지 뭐 제대로 한 게 없음 ㅋㅋㅋ.
정제: 오신세좋네ㅋㅋㅋㅋㅋㅋㅋㅋㅋㅋ	오 신세 좋네 ㅋㅋㅋㅋㅋㅋㅋㅋㅋㅋ.
정제: 엥몇명이 한존데	엥 몇 명이 한 조인데.
정제: 4명ㅋㅋㅋ	4명 ㅋㅋㅋ.
정제: ㅋㅋㅋㅋㅋㅋㅋㅋ	ㅋㅋㅋㅋㅋㅋㅋㅋ
정제: ㅋㅋㅋㅋ니는어디임지금??	ㅋㅋㅋㅋ 너는 어디임 지금??
정제: 연암가야댐ㅋㅋㅋㅋㅋㅋ	연암 가야 됨ㅋㅋㅋㅋㅋㅋ
정제: 아직조별중임?	아직 조별 중임?
정제: ㄴㄴㄴㄴ나지금노래방임ㅋㅋㅋ	ㄴㄴㄴㄴ 나 지금 노래방임 ㅋㅋㅋ
정제: 비싸드랑	비싸더라.
정제: #@시스템#검색#	#@시스템# 검색.
정제: 비싸당 ㅋㅋㅋㅋㅋ	비싸다 ㅋㅋㅋㅋㅋ
정제: 오홍	오홍.
정제: 그래도 괜찮은디	그래도 괜찮은데
정제: 사부릴까 우리동 ㅋㅋㅋ	사버릴까 우리도 ㅋㅋㅋ.
정제: ㅇㅅㅇ	ㅇㅅㅇ
정제: 비싸...	비싸...
정제: 으으 알겠다요 돈 아끼야겠다	으으 알겠다요, 돈 아껴야겠다.
정제: ㅋㅋㅋㅋㅋㅋㅋ	ㅋㅋㅋㅋㅋㅋㅋ
정제: 그글로 소고기 사묵장	그걸로 소고기 사먹자.
정제: 헿	헿.
정제: ㅋㅋㅋㅋㅋㅋ그기므야	ㅋㅋㅋㅋㅋㅋ그게 뭐야
정제: 소고기 물까 오랜만에	소고기 먹을까 오랜만에
정제: 쏘쏘쏘 괴기괴기	쏘쏘쏘 괴기괴기.
정제: 쇼핑해쏘	쇼핑했어
정제: 오잉	오잉
정제: 이게믕가요 ㅋㅋㅋㅋ	이게 뭔가요 ㅋㅋㅋㅋ
정제: 여부 나는 좀자다가 저녁먹고 가야겠어요	여보 나는 좀 자다가 저녁 먹고 가야겠어요.
정제: 저거 캐리어진짜 커	저거 캐리어 진짜 커.
정제: ㅜㅜㅜ	ㅜㅜㅜ
정제: #@이름#꺼보다 커 ??	#@이름# 꺼보다 커 ??
정제: 언래잇던거	원래 있던 거
정제: 웅 훨씬커	응 훨씬 커.
정제: ㄷ ㄷ	ㄷ ㄷ
정제: 나도 유럽갈때	나도 유럽 갈 때
정제: 하나 사거야지	하나 사가야지
정제: #@이름#이 양복 얼마주고삿으??	#@이름#이 양복 얼마 주고 샀어??
정제: 정장	정장
정제: 음	음
정제: 20만인가	20만 원인가
정제: 20~30사이일걸	20~30 사이일 걸
정제: 50만원짜리면	50만 원짜리면
정제: 비싼거네?	비싼거네?
정제: #@이름#이꺼 어디꺼야??	#@이름#이 거 어디 거야??
정제: 비싼거 같은데	비싼 거 같은데.
정제: TNGT	TNGT
정제: 거기서 삿으	거기서 샀어
정제: 백화점서 산거지?	백화점에서 산 거지?
정제: 맞춤아니구	맞춤 아니고.
정제: 엉	응
정제: 근데 갑자기 홰	근데 갑자기 왜
정제: ㅋㅋ	ㅋㅋ
정제: 동생	동생
정제: 하나 사야된다하길래	하나 사야 된다고 하길래.
정제: 정장아예없어서	정장이 아예 없어서
정제: 사촌오바 결혼식때	사촌오빠 결혼식 때.
정제: 다음에는 곽티슈를	다음에는 곽티슈를
정제: 좀 더 작은 사이즈로	좀 더 작은 사이즈로.
정제: 사는게 좋을 거 같아🙄🙄	사는 게 좋을 거 같아🙄🙄
정제: 직사각형 말고	직사각형 말고.
정제: 정사각형 곽티슈 말하는 거지?	정사각형 곽티슈 말하는 거지?
정제: 응 맞아	응, 맞아.
정제: 그게 자리 차지도 덜할 거 같거든	그게 자리 차지도 덜할 거 같거든.
정제: 게다가 더 경제적이긴 하겠다	게다가 더 경제적이긴 하겠다.
정제: 공간차지도 덜 하고ㅎ	공간 차지도 덜 하고ㅎ
정제: 응 장점이 이렇게 많아	응, 장점이 이렇게 많아.
정제: 그런데 언니 기억이 맞다면	그런데 언니 기억이 맞다면.
정제: 정사각형 곽티슈는 희안하게	정사각형 곽티슈는 희안하게.
정제: 휴지 질이 좀 떨어지는 거 같더라	휴지 질이 좀 떨어지는 것 같더라
정제: 아 그랬어??	아, 그랬어?
정제: 응 사용해봤던 제품들은!	응, 사용해 봤던 제품들은!
정제: 그러면 다른 브랜드의	그러면 다른 브랜드의
정제: 곽티슈를 사보자!	곽티슈를 사보자!
정제: 590 610	590 610
정제: 두개 매도는 걸어놔	두 개 매도는 걸어놔.
정제: 50%만	50% 만
정제: 25% 25%식	25% 25% 식
정제: 물량	물량
정제: 아 그래?	아, 그래?
정제: ㅇㅇ	응응
정제: 분할익절해놔야지	분할 익절해놔야지.
정제: 소량만 900원	소량만 900원
정제: 목표가지	목표 가지.
정제: 엄청난 단타구나	엄청난 단타구나.
정제: ㅋㅋㅋ 벌써 570원대	ㅋㅋㅋ 벌써 570원대.
정제: 딴타인데 이 장도면	딴타인데 이 장도면.
정제: 회귀했누	회귀했네
정제: 여름에 글케 발바닦이 뜨거워 날 괴롭히다니	여름에 그렇게 발바닥이 뜨거워 날 괴롭히다니.
정제: 이젠 발시려	이젠 발 시려.
정제: ㅋㅋㅋㅋㅋㅋㅋㅋ	ㅋㅋㅋㅋㅋㅋㅋㅋ" -> "ㅋㅋㅋ
정제: 나 사고싶어 선생님...	나 사고 싶어 선생님...
정제: 호에ㅜㅜ	호에ㅜㅜ
정제: 어으 기절했었다	어으 기절했었다.
정제: 싸긴하다 거의 새건데ㅜㅜ	싸기는 하다 거의 새건데ㅜㅜ.
정제: 누가 이미 사갓대 ㅜㅠㅋㅋㅋ	누가 이미 사갔대 ㅜㅠㅋㅋㅋ
정제: 물어봤더니?? ㅜㅜ	물어봤더니??
정제: ㅠㅠ이러뉴ㅠㅠㅠ	ㅠㅠ 이런ㅠㅠㅠ.
정제: 응 ㅜㅜㅋㅋ	응 ㅜㅜ ㅋㅋ.
정제: 물어보느라 당근 가입한김에 두산 야구담바 올렷는데	물어보느라 당근 가입한김에 두산 야구잠바 올렸는데.
정제: 안사갈긋...ㅌㅌㅋ	안 사갈 듯... ㅌㅌㅋ.
정제: ㅠㅠㅋㅋㅋㅋㅋ야구잠바 얼마에 올렸엌ㅋㅋㅋㅋㅋ	ㅠㅠㅋㅋㅋㅋㅋ 야구 잠바 얼마에 올렸어ㅋㅋㅋㅋㅋ
정제: 3만원에 올렷어	3만 원에 올렸어.
정제: 조회수도 미미해	조회수도 미미해.
정제: 저 일단 5:20하나 잡앗어요	저 일단 5:20 하나 잡았어요.
정제: 5:20가랴면 따로 앉아야하긴 할듯?!	5:20 가려면 따로 앉아야 하긴 할 듯?!
정제: 이번엔 쿠폰씀 겔겔..	이번엔 쿠폰 썼다. 겔겔..
정제: 다들 쿠폰써서 하나씩 잡아볼가염	다들 쿠폰 써서 하나씩 잡아볼까여.
정제: 몇탕을 뛰는거애	몇 탕을 뛰는 거야.
정제: 앗?	앗?
정제: Mx?	Mx?
정제: 내	네
정제: 제가 갖고 잇는게 2:40이구	제가 갖고 있는 게 2:40이고
정제: 지금 5:20 열렷어용	지금 5:20 열렸어요.
정제: 어떻게 푸는거애	어떻게 푸는 거야
정제: 아니 쿠폰 어떻게 받는거지	아니 쿠폰 어떻게 받는 거지.
정제: 기달	기다려
정제: 이벤트 배너!!	이벤트 배너!!
정제: 나도 다섯시꺼 쿠폰 써서 잡아쏘	나도 다섯 시꺼 쿠폰 써서 잡았어.
정제: 앱에서 맨 왼쪽 위에 가로작대기 세개 눌러서 이벤트 들어가서	앱에서 맨 왼쪽 위에 가로 작대기 세 개 눌러서 이벤트 들어가서
정제: 쭉 내리면 mx 3000어쩌규... 클릭	쭉 내리면 mx 3000 어쩌구... 클릭.
정제: #@이름#언니 자리워디	#@이름# 언니 자리 어디에요?
정제: 나 i15?	나 i15?
정제: 저 h15	저 H15.
정제: 아싸 감사용	아싸 감사해요
정제: 머가용?	뭐가요?
정제: 삼천원 아꼇다 (작은 것에 기뻐하는 편)	삼천원 아꼈다 (작은 것에 기뻐하는 편)
정제: ㅋㅋㅋㅋㅋㅋㅋㅋ 나도나도 오예~	ㅋㅋㅋㅋㅋㅋㅋㅋ 나도 나도 오예~
정제: 여덟시늠 자리 저긴데	여덟 시는 자리 저긴데.
정제: 저기나 여기나겠지..?	저기나 여기나겠지..?
정제: 게다가 같은 시간대에 보는거니까	게다가 같은 시간대에 보는 거니까.
정제: 글고 생각해보니 저 11:30치과이고 치과 파준데 2:40 쩜... 간당간당이엇네	그리고 생각해보니 저 11:30 치과이고 치과 파주인데 2:40 쩜... 간당간당이었네.
정제: 8시건 늦으니까.. 그거 감안하면 아이15도 갠찮은거같아여	8시간 늦으니까.. 그거 감안하면 아이 15도 괜찮은 거 같아요.
정제: 오빠 차 펠리세이드	오빠 차 펠리세이드.
정제: 바로 살수있는차 나왔는데	바로 살 수 있는 차 나왔는데
정제: 4000만원정도한다	4000만원 정도 한다.
정제: 사고싶다	사고 싶다.
정제: 헉ㅋ옵션은어때?	헉ㅋ 옵션은 어때?
정제: 보험까지다하면4000될거같아?ㅋ	보험까지 다 해서 4000 될 거 같아? ㅋ
정제: 웅웅	응응
정제: 어쩌고싶어? k5팔고사?	어쩌고 싶어? k5 팔고 사?
정제: 참았다가 12월에사면	참았다가 12월에 사면
정제: 200만원 더 할인받기는하는데	200만원 더 할인 받기는 하는데
정제: 200이믄 크긴하당	200이면 크긴 하다.
정제: 좀만더타던지ㅋ	좀만 더 타든지 ㅋ
정제: 그쯤 사믄 딱좋긴한데	그쯤 사면 딱 좋긴 한데.
정제: 하아 갈등이네	하아, 갈등이네.
정제: 지금사는것도 전시차긴 하다	지금 사는 것도 전시차긴 하다.
정제: 그럼 좀만 참아라	그럼 좀만 참아라.
정제: 어짜피같은 전시차믄 할인할때사자	어차피 같은 전시차면 할인할 때 사자.
정제: 이득볼수있음 이득있을때 사자	이득 볼 수 있으면 이득 있을 때 사자.
정제: 저기 비싸진아늠	저기 비싸진 않아.
정제: 파이류는 3500?	파이류는 3500?
정제: 핫도그는 가격 다양	핫도그는 가격 다양해.
정제: 그래도 5000은 안넘길걸	그래도 5000은 안 넘길 걸
정제: 테잌아웃전문임	테이크아웃 전문이야
정제: 그래서 사가지고 홍대 놀이터에서 챱챱하던지 걸어감서 챱챱해야대	그래서 사가지고 홍대 놀이터에서 챱챱하던지 걸어갔는데 챱챱해야 돼.
정제: 보통은 놀이터서 챱챱함	보통은 놀이터에서 챱챱함.
정제: 찾아보니까	찾아보니까
정제: 주니어 핫독먹고서	주니어 핫도그 먹고서
정제: 미트파이 머금됨ㅎ	미트파이 먹으면 됨ㅎ
정제: 2700원정도하는거같은디	2700원 정도 하는 거 같은데
정제: 미트파인 내거야	미트파이는 내거야.
정제: 차라리 치킨파이를 사	차라리 치킨 파이를 사.
정제: 나도 먹을꺼여	나도 먹을 거야
정제: 반반해먹자	반반 해먹자
정제: 그랭ㅎ	그래ㅎ
정제: 우리 가는 빈티지샵 요일마다 가격달라지나봄	우리 가는 빈티지 샵 요일마다 가격 달라지나 봐.
정제: 우리 맨처음이랑 두번째로 고터갔을땐	우리 맨 처음이랑 두 번째로 고터 갔을 땐.
정제: 무슨 요일이었지?	무슨 요일이었지?
정제: 기억 안나는데.. 언제였지?	기억 안나는데.. 언제였지?
정제: 처음이랑 두번째 고터간날	처음이랑 두 번째 곳에 간 날
정제: 처음 화욜 둘째 화욜 셋째 금욜	처음 화욜 둘째 화욜 셋째 금욜
정제: 그럼 요일은 또 아니네	그럼 요일은 또 아니네.
정제: 그냥 자기들 맴인가	그냥 자기들 마음인가.
정제: 그런가봐 자기들 맘대로 가격붙이나봄	그런가봐. 자기들 맘대로 가격 붙이나 봐.
정제: 칫.. 요일 알면 쌀때만 가면좋은데	칫.. 요일 알면 쌀 때만 가면 좋은데.
정제: 하모 그러게말이야	하모 그러게 말이야.
정제: 핑크랑 블랙 중에 뭐살가	핑크랑 블랙 중에 뭐 살까
정제: 핑크	핑크
정제: 얘쁜데..?	예쁜데..?
정제: 아오 블랙이 넘 압도적이였오	아오, 블랙이 넘 압도적이었어.
정제: 두개 살라거 후후	두 개 살라고. 후후.
정제: 아 머야 ㅋ	아 뭐야 ㅋ.
정제: 멀 고만한 거야 ㅋ	뭘 고민한 거야 ㅋ
정제: 사실 내 픽은 하늘색	사실 내 픽은 하늘색.
정제: 저도 제 원픽이 하늘이였다조,,	나도 제 원픽이 하늘이었다죠,,
정제: 후후	후후
정제: 바로 지름	바로 지름.
정제: 하늘..하늘..?	하늘.. 하늘..?
정제: 어...!?	어... !?
정제: 아앗,,,,	아앗...
정제: 경영인을 바꿨대요 언냐ㅠ	경영인을 바꿨대요 언니야ㅠ
정제: 강남 예카 조지는중	강남 예카 조지는 중
정제: #@시스템#검색#	#@시스템# 검색.
정제: 아니 이 정도면	아니, 이 정도면.
정제: 강남에서 자취해!!	강남에서 자취해!!
정제: 나 자취하면 너 매주 강남 와야혀	나 자취하면 너 매주 강남 와야 해.
정제: ㅋㅋㅋ 나도 망설였는데	ㅋㅋㅋ 나도 망설였는데.
정제: 매장 언니가 넘나 강추해서	매장 언니가 넘나 강추해서.
정제: 대략 지름 ㅎ	대략 지름 ㅎ
정제: 오	오
정제: 모자이뿌다!!!!!!!	모자 이쁘다!!!!!!!
정제: 온라인에 2000개씩 들어가도 바로 품절된다고	온라인에 2000개씩 들어가도 바로 품절된다고.
정제: 지금 두개 남았다고	지금 두 개 남았다고.
정제: 잘어울려!!!!	잘 어울려!!!!
정제: 얼른 챙기랰ㅋㅋ	얼른 챙기래ㅋㅋ
정제: 감사해욘 ㅎㅎ	감사해요 ㅎㅎ
정제: 무난해서 샀어욘 ㅎㅎ	무난해서 샀어요 ㅎㅎ
정제: 헐	헐.
정제: 이뿌다!!!!!!!	이쁘다!!!!!!!
정제: 쇼룸에서 찍어봄 ㅎㅎ	쇼룸에서 찍어봄 ㅎㅎ.
정제: 모델이세여...?	모델이세요...?
정제: ㅎ당건ㅎ	ㅎ당근ㅎ
정제: seche 탑코트 이거	seche 탑코트 이거.
정제: 머야 이뻐 ㅋㅋㅋ	뭐야 이뻐 ㅋㅋㅋ
정제: 나름 좋아	나름 좋아.
정제: 젤탑코트같고 빨리말라	젤탑코트 같고 빨리 말라.
정제: 네일샵다녀온거 ㅋㅋㅋ	네일샵 다녀온 거 ㅋㅋㅋ.
정제: 오 일반네일아냐?	오, 일반 네일 아니야?
정제: 젤이야?	젤이야?
정제: 일반이야 ㅋㅋㅋ	일반이야 ㅋㅋㅋ.
정제: 금방 오는거아녀?	금방 오는 거 아니야?
정제: 오래걸린대?	오래 걸린대?
정제: 학교갔다왔는데 집앞에 매트리스있으면 힘들거같아..	학교 갔다왔는데 집 앞에 매트리스 있으면 힘들거 같아..
정제: 문의해도 다 언제갈지모른다 기다려라 이런거뿐이던데	문의해도 다 언제 갈지 모른다. 기다려라, 이런 거 뿐이던데.
정제: 그건 그렇긴한데ㅠㅠ	그건 그렇긴 한데ㅠㅠ.
정제: 예상 그런것도 없어	예상 그런 것도 없어.
정제: 뭐냠, ,,,	뭐냐...
정제: 에바네 ㅡㅡ	에바네. ㅡㅡ
정제: 휴도 그렇게 굴래?!?	휴도 그렇게 굴래?!?
정제: 근데 화물이라는게 케바케다	근데 화물이라는 게 케바케다.
정제: 기사님마다 그게 차이가 클듯	기사님마다 그게 차이가 클듯.
정제: 넘 복불복쓰	너무 복불복.
정제: 좀 더 빨리 시킬걸 그랫남	좀 더 빨리 시킬걸 그랬는나.
정제: 젝아 일찍 시키라고 했잖아욘~~	젝아, 일찍 시키라고 했잖아요~~
정제: 근데 애초에 너가 마음정한게	근데 애초에 너가 마음정한 게.
정제: 얼마안되지 않았어?ㅋㅋㅋ	얼마 안 되지 않았어?ㅋㅋㅋ
정제: 어쩔 수 없었다	어쩔 수 없었다.
정제: 아니 넘 빨리 도착하면 어쩌나싶어서	아니 너무 빨리 도착하면 어쩌나 싶어서
정제: 문따고 들어가서 넣어주는진 몰랐지	문따고 들어가서 넣어주는 건 몰랐지.
정제: 맞아 내가 고민도 오지게 했지	맞아, 내가 고민도 오지게 했지.
정제: #@이름#	#@이름#
정제: 배그중?	배그 중?
정제: ㅇㅇㅇ	ㅇㅇㅇ
정제: 계속 할거징?	계속 할거징?" -> "계속 할 거징?
정제: 모르겟움	모르겠음
정제: 배그	배틀그라운드
정제: 결재	결재
정제: 한다	한다.
정제: 이제 너꺼 안씀	이제 너 꺼 안 씀.
정제: ㅋㅋㅋㅋ	ㅋㅋㅋㅋ
정제: 아닌가	아닌가.
정제: #@기타# 카카오로 가야하나	#@기타# 카카오로 가야 하나.
정제: ㅋㅋㅋㅋㅋㅋㅋㅋㅋㅋㅋㅋ	ㅋㅋㅋㅋㅋㅋㅋㅋㅋㅋㅋㅋ
정제: 카카오보단 스팀이지	카카오 보단 스팀이지.
정제: 일단	일단
정제: 지른다	지른다.
정제: 고고	고고
정제: 상하이세트 할인인가? 뭐짘ㅋㅋ	상하이 세트 할인인가? 뭐지ㅋㅋ.
정제: 세트시켰는데가격은10400원나왓네 영수증봤더니	세트 시켰는데 가격은 10400원 나왔네. 영수증 봤더니.
정제: 왜??	왜?
정제: ㅋㅋㅋㅋ왤케싸	ㅋㅋㅋㅋ 왜 이렇게 싸
정제: 세개샀는데?	세 개 샀는데?
정제: 아 원래이가격인가?몰랔ㅋㅋ	아, 원래 이 가격인가? 몰라ㅋㅋ
정제: 아니두개샀엌ㅋㅋㅋ	아니 두 개 샀어ㅋㅋㅋ.
정제: 내가비싸게 오해했나보다	내가 비싸게 오해했나 보다.
정제: ㅋㅋㅋ맥도날드는 글케안비싸	ㅋㅋㅋ 맥도날드는 그렇게 안 비싸
정제: 글쿤 ㅋㅋㅋㅋ 싸구나	그렇군 ㅋㅋㅋㅋ 싸구나.
정제: 체스키가 그 축제열리는데??	체스키가 그 축제 열리는데??
정제: 2시간이면 계획잘짜서 후딱 보고 사고 사진찍고 와야겠다	2시간이면 계획 잘 짜서 후딱 보고 사고 사진 찍고 와야겠다.
정제: 포켓 와이파이는 어떻게 할거임?	포켓 와이파이는 어떻게 할 거야?
정제: 아 그 축제 그때 아니더라ㅜ 살짝 비껴감	아 그 축제 그때 아니더라ㅜ 살짝 비껴갔어.
정제: 아...아쉽..	아... 아쉬워..
정제: 그냥 점심먹고 좀 둘러보면 될듯	그냥 점심 먹고 좀 둘러보면 될 듯
정제: 그걸로 충분하대 애들이	그걸로 충분하대 애들이.
정제: ㅋㅋㅋㅋ	ㅋㅋㅋㅋ
정제: 알겠음	알겠어.
정제: 페북 스투디 플래너도 뭐 자주 올라옴	페북 스터디 플래너도 뭐 자주 올라와.
정제: 게시물 저장ㄱ	게시물 저장한다.
정제: 스투디 플래너가 뭐야	스투디 플래너가 뭐야.
정제: 아 스투비	아, 스투비.
정제: 페북 페이지	페북 페이지
정제: ㅇㅇ 오키	ㅇㅇ 오케이.
정제: #@시스템#기타#	#@시스템# 기타.
정제: #@URL#	#@URL#
정제: 가격 괜춘한듯 하자	가격 괜찮은 듯 하자.
정제: 5인하면 거의 40만 아님?	5인 하면 거의 40만 아님?
정제: 시간대비 비싼 것 같은데	시간 대비 비싼 것 같은데.
정제: 옷은 늘 살 수 있나ㅎㅎ	옷은 늘 살 수 있나ㅎㅎ.
정제: 살 옷?? 많아ㅋㅋ	살 옷?? 많아 ㅋㅋ.
정제: 나 주차가..	나 주차가..
정제: 구경할거야	구경할 거야
정제: 1시간밖에 안들어있어서	1시간 밖에 안 들어 있어서
정제: 돈을 써야해..ㅋㅋ	돈을 써야 해.. ㅋㅋ
정제: 맞당ㅎㅎ 나 자기 차번호 알려줘용	맞다 ㅎㅎ 나 자기 차번호 알려줘요.
정제: #@번호#!	#@번호#!
정제: 이따 커피마시거나 옷사거나	이따 커피 마시거나 옷 사거나.
정제: 다 되는거잖아??	다 되는 거잖아??
정제: 안그래도 가서 물어보려고 했엉	안 그래도 가서 물어보려고 했어.
정제: 자기ㄱ	자기 가자.
정제: ㅋㅋㅋ이걸로 사??	ㅋㅋㅋ 이걸로 사??
정제: 돈 다 쓰고왕ㅋㅋ	돈 다 쓰고 와ㅋㅋ
정제: 안갈 수 없겠네..	안 갈 수 없겠네..
정제: 대신!	대신!
정제: 너무 큰 유혹이다	너무 큰 유혹이다.
정제: 그스프레이?로	그 스프레이로
정제: 더티	더티.
정제: 나도 갖고 시픈데	나도 갖고 싶은데.
정제: 여자들도 뿌리냐	여자들도 뿌리냐.
정제: 뿌리지	뿌리지
정제: 남자꺼아녀	남자꺼 아니야.
정제: 일단 내가 갖고있는건 스프레이긴한데	일단 내가 갖고 있는 건 스프레이긴 한데.
정제: 거기는 그거 없나?	거기는 그거 없나?
정제: 29하이스트리트	29 하이스트리트
정제: 없겠지 ..... 호주에만 팔겠지 .. 오케이	없겠지.....호주에만 팔겠지..오케이.
정제: 없지없지	없지 없지
정제: 영국 다녀와?	영국 다녀와?
정제: 자가격리하면되지ㄱㄱ	자가 격리하면 되지. 가자
정제: 위에께나아	위에 게 나아.
정제: 위에꺼 살까 말까 하면	위에 거 살까 말까 하면
정제: 사지마라야?	사지 마라야?
정제: 밑에꺼 예쁜거같은데.......	밑에 꺼 예쁜 거 같은데.......
정제: 가격은?	가격은?
정제: 둘다	둘 다
정제: 18000	18000
정제: 15600?	15600?
정제: 얼마안행	얼마 안 해
정제: 그럼샄ㅋㅋ`	그럼 사ㅋㅋ.
정제: 엣지	엣지
정제: 피자 잡은손	피자 잡은 손
정제: 손 크로아상같네	손 크로아상 같네
정제: 미소가 아름다운사람이야	미소가 아름다운 사람이야.
정제: 먹을때	먹을 때
정제: #@이름# 곰돌이옷 잘어울리네	#@이름# 곰돌이 옷 잘 어울리네.
정제: 친이모가 다른 곰돌이 옷 사주면 되겠다	친이모가 다른 곰돌이 옷 사주면 되겠다.
정제: 난 행복합니다~~	나 행복합니다~~
정제: 나 할머니 생신선물 드려야돼	나 할머니 생신 선물 드려야 돼.
정제: 이모 돈 없어	이모 돈 없어.
정제: 담달 이모 생일이야 이모 생일선물 준비해	다음 달 이모 생일이야 이모 생일 선물 준비해.
정제: #@이름#이는 담달에 진짜 거지야	#@이름#이는 다음 달에 진짜 거지야.
정제: 이모는 아무것도 안주고 아무것도 안받을게	이모는 아무것도 안 주고 아무것도 안 받을게.
정제: ㅋㅋㅋㅋㅋㅋㅋ	ㅋㅋㅋㅋㅋㅋㅋ
정제: 할머니생신언제냐	할머니 생신 언제냐.
정제: 기프티콘 보내드려도 되니	기프티콘 보내 드려도 되니
정제: 맘대루해	맘대로 해
정제: 할머니 별거아니지만 요거프레소 기프티콘 보냅니다	할머니 별거 아니지만 요거프레소 기프티콘 보냅니다.
정제: 할머니 못쓰실거 같아	할머니 못 쓰실 거 같아.
정제: 메리딸기 시즌이더라구요	메리딸기 시즌이더라구요.
정제: 그제잉가?	그제인가?
정제: 아 최근에 산거구나....	아, 최근에 산 거구나....
정제: 그랬구나..그랬어..	그랬구나.. 그랬어..
정제: 다 #@이름#한테 쓰려고 산거야!	다 #@이름#한테 쓰려고 산 거야!
정제: 이거 다 #@이름#꺼	이거 다 #@이름# 꺼
정제: 귀여운것만 골라 샀네	귀여운 것만 골라 샀네.
정제: 하 오늘 너무 시르다	하 오늘 너무 싫다.
정제: 빤스런 하고 싶어	빤스런 하고 싶어
정제: 회사에서	회사에서
정제: #@이름#도?	#@이름# 도?
정제: 나도...	나도...
정제: 10시반밖에 안됏어..	10시 반밖에 안 됐어..
정제: 실화냐..	실화냐..
정제: #@이모티콘#	#@이모티콘#.
정제: 돈내놔새끼들아	돈 내놔 새끼들아.
정제: 일처리째깍째깍하란말이야	일처리째깍째깍 하란 말이야.
정제: 나는 응개중	나는 응가 중
정제: 오잉?	오잉?
정제: 응개하면서카톡즁?	응가하면서 카톡 중?
정제: 냐 응개쟁이다	냐 응가쟁이다.
정제: 색깔뭐가이뽀	색깔 뭐가 이뻐.
정제: 디자인어때	디자인 어때.
정제: 음	음.
정제: 색깔은3번이녜쁘고	색깔은 3번이 예쁘고
정제: 1,2번은 나이들어보일것같아	1,2번은 나이들어 보일 것 같아.
정제: 디자인은그냥그래	디자인은 그냥 그래.
정제: #@이모티콘#하하#	#@이모티콘# 하하.
정제: 나도그냥물어봐쓔	나도 그냥 물어봤어.
정제: 모델이진짜마르고몸선이이뻐서	모델이 진짜 마르고 몸선이 이뻐서.
정제: 한번 보내봤다	한번 보내봤다.
정제: 이번에 산거?	이번에 산 거?
정제: 응	응.
정제: 홍대가자	홍대 가자.
정제: 예전에 내가 추천해준곳인데	예전에 내가 추천해 준 곳인데.
정제: 맞아	맞아.
정제: 맞아	맞아.
정제: ㅋㅋㅋㅋㅋ	ㅋㅋㅋㅋㅋ
정제: 아 또 생각났다	아 또 생각났다.
정제: 로즈 아로마오일	로즈 아로마 오일
정제: 오	오.
정제: 그것도 좋도	그것도 좋고.
정제: 다	다.
정제: 겁나비싸	겁나 비싸.
정제: 얼마양	얼마야.
정제: 파는곳 마다 좀 달라	파는 곳마다 좀 달라.
정제: 근데 100퍼 원액으로 사면 여툰 비싸	근데 100퍼 원액으로 사면 여튼 비싸.
정제: 내가 3퍼 희석액으로 사봤는데	내가 3% 희석액으로 사봤는데
정제: 힝	힝
정제: 옹	오.
정제: 비싸도 100퍼 사는게 나을듯	비싸도 100퍼 산는 게 나을 듯
정제: 헐 왤케 오래된거같지 ㅇㅅㅇ	헐 왜 이렇게 오래된 거 같지 ㅇㅅㅇ.
정제: 나 그때 자켓 입고 있었다구	나 그때 자켓 입고 있었다고.
정제: 그때가 좋았는뎅	그때가 좋았는데.
정제: 날씨도 선선하니	날씨도 선선하니.
정제: 흠 마쟈 ㅇㅅㅇ	흠 맞아 ㅇㅅㅇ.
정제: 나 모노키니 샀는데	나 모노키니 샀는데
정제: 오늘샀는데 벌써 발송했데	오늘 샀는데 벌써 발송했대.
정제: ㅋㅋㅋㅋㅋㅋㅋ개이득	ㅋㅋㅋㅋㅋㅋㅋ 개이득.
정제: 낼 오겠당 우체국이얌	낼 오겠다 우체국이야.
정제: 우아	우와.
정제: 비키니 이런거 금방 배송 하더라	비키니 이런 거 금방 배송하더라.
정제: 너 호텔갈떄 입으려구	너 호텔 갈 때 입으려구
정제: 산거지ㅇㅂㅇ	산 거지ㅇㅂㅇ
정제: 캬캬	캬캬
정제: 맞아 ㅇㅂㅇ	맞아. ㅇㅂㅇ
정제: 비키니처럼 분리된거사려다가	비키니처럼 분리된 거사려다가
정제: 뱃살튀어나올까바	뱃살 튀어나올까 봐
정제: 모노키니로 해써 헤헤	모노키니로 해써 헤헤.
정제: ㅁㅈ 나 분리된거 샀다가	맞아 나 분리된 거 샀다가.
정제: 후회했자나..	후회했잖아..
정제: 니쩌로유	니쩌로유
정제: 니짜로우	니짜로우
정제: 예뽀	예뽀
정제: 근데 니짜로우가 아니라 니짜래	근데 니쟈로우가 아니라 니쟈래.
정제: ㅋㅋㅋㅋㅋ오맘원이길래 걍 사써..	ㅋㅋㅋㅋㅋ 오만원이길래 그냥 샀어..
정제: 로우버전이 아닌가바	로우 버전이 아닌 가 봐.
정제: 근데 인터넷은 이만얼마야	근데 인터넷은 이만 얼마야.
정제: 나 사기당한걸까	나 사기당한 걸까.
정제: 홀랭????	헐???
정제: ㅋㅋㅋㅋㅋㅋㅋㅋㅋㅋ	ㅋㅋㅋㅋㅋㅋㅋㅋㅋㅋ
정제: 근데 나 오늘 밥먹은데	근데 나 오늘 밥 먹은데.
정제: 옴청 마시써	엄청 맛있어.
정제: 너네랑 같이가고시퍼	너네랑 같이 가고 싶어.
정제: 엄청 맛있어서	엄청 맛있어서
정제: 가자	가자
정제: 먹으면서 계속 맛있다그래써	먹으면서 계속 맛있다 그랬어.
정제: 버뮤다	버뮤다.
정제: 이태원안간지 오래됔서	이태원 안 간지 오래됐어.
정제: 나도 정말 오랜만에 와	나도 정말 오랜만에 와.
정제: ㅋㅋㅋ	ㅋㅋㅋ
정제: 난 타공판 예쁜데 흔한디자인은 싫대	난 타공 판 예쁜데 흔한 디자인은 싫대.
정제: 흔한게	흔한 게
정제: 왜흔하겠어	왜 흔하겠어.
정제: 이쁘니까흥하지	이쁘니까 흔하지.
정제: 그니까!!	그니까!!
정제: 귀걸이를 어따두고팔라고	귀걸이를 어디다 두고 팔라고.
정제: 짜증나게하네	짜증나게 하네.
정제: 넘예뻐	넘 예뻐.
정제: 타공판두고해	타공 판 두고 해.
정제: 한쪽벽은	한쪽 벽은
정제: 이대로고	이대로 고
정제: 한쪽은 저대로하면 괜찮지?	한쪽은 저대로 하면 괜찮지?
정제: 웅 넘 예뻐	웅 넘 예뻐.
정제: 왜 대충말해?	왜 대충 말해?
정제: 진심인걸?	진심인걸?
정제: 근데	근데
정제: 저한쪽벽에도귀걸이전시할거래?	저 한쪽 벽에도 귀걸이 전시할 거래?
정제: 그렇게종류가많어?	그렇게 종류가 많아?
정제: 대단하군	대단하군.
정제: 기존에도 양쪽으로햇으니까	기존에도 양쪽으로 했으니까
정제: 종류가많나보지!	종류가 많나 보지!
정제: 어우눈아프겠다	어우 눈 아프겠다.
정제: 3분만	3 분만
정제: 헤헤	헤헤
정제: 메이웨더랑	메이웨더랑
정제: 호날두랑	호날두랑
정제: 어	어
정제: 등등이 쓴데	등등이 쓴데
정제: 헤헤	헤헤.
정제: 근육통을 없애주는 효과가	근육통을 없애주는 효과가.
정제: 탁월하뎅	탁월하대.
정제: 오오옹	오오오.
정제: #@이름#이두	#@이름# 이도.
정제: 할래	할래.
정제: 헷	헷헷
정제: 헤	헤
정제: 4000마넌이랭	4000 만원이래.
정제: 이히히히히히히히히	이히히히히히히히히
정제: 400도아닌	400도 아닌
정제: 4000...?	4000...?
정제: 앙!!	앙!!
정제: 비쨔...	비싸...
정제: 나	나
정제: 애뽈워치	애플 워치
정제: 사써	사서 써
정제: 오호	오호.
정제: 보자보자	보자 보자
정제: 근데나 그런가에	근데 나 그런거에
정제: 관심이없어서그런데	관심이 없어서 그런데.
정제: 무슨기능잇나요	무슨 기능 있나요.
정제: 궁금합니다	궁금합니다.
정제: 운동?	운동?
정제: 마자	맞아
정제: 운동할ㄸ ㅐ	운동할 때
정제: 그것만 들고가서 음악도 들을 슈 잇거	그것만 들고 가서 음악도 들을 수 있고
정제: 전화도 할슈잇거	전화도 할 수 있고
정제: 카톡도할수잇거	카톡도 할 수 있고
정제: 문자도할수이ㅛ고ㅔ	문자도 할 수 있고
정제: 뭐 기타등등 이서저거	뭐 기타 등등 이거저거
정제: 많은데	많은데
정제: 그냥 예뻐서 삿서	그냥 예뻐서 샀어.
정제: ㅎㅎ	ㅎㅎ
정제: 오호	오호
정제: 스마트해요	스마트해요
정제: 이쁘다고 생각햇는데	이쁘다고 생각했는데.
정제: 이렇게 큰가	이렇게 큰가.
정제: 작은더 품절 ㅠㅠ	작은 거 품절 ㅠㅠ
정제: 아직안삿어	아직 안 샀어.
정제: 이거어때	이거 어때
정제: 99000원	99000원
정제: 할인받아서	할인 받아서
정제: 얼만데	얼만데
정제: 153000원	153,000원
정제: 장바구니에 안들어가 있는데?	장바구니에 안 들어가 있는데?
정제: 전화 할 때 모 들었어..장바구니 안되고..	전화할 때 뭐 들었어.. 장바구니 안 되고..
정제: 바로 예약결제해야한당게.	바로 예약 결제해야 한다니까.
정제: 레저도 없고	레저도 없고
정제: 투어	투어
정제: 인터파크 - 투어 - 국내항공	인터파크 - 투어 - 국내항공
정제: 아 투어.	아 투어
정제: 없는데 앱에선 안되나	없는데 앱에선 안 되나
정제: 투어 새로 ㄲᆞㄹ았어	투어 새로 깔았어
정제: 앱에 안나오는것 같은디...항공권이..	앱에 안 나오는 것 같은데... 항공권이..
정제: 찾아봐바	찾아봐.
정제: 투어 새로 깔면돼	투어 새로 깔면 돼.
정제: 아니...내 말은 투어에	아니... 내 말은 투어에.
정제: 조회되는데	조회되는데
정제: 혀바바..	해봐..
정제: 경 영믄ㄴ?	그냥 영문?
정제: #@이름#	#@이름#
정제: 인증번호	인증번호
정제: #@번호#	#@번호#
정제: 또	또
정제: #@번호#	#@번호#
정제: 정수기 바꿀까 생각중이야	정수기 바꿀까 생각 중이야.
정제: 어떤걸로 바꾸려고?	어떤 걸로 바꾸려고?
정제: 렌탈 계약 끝나서 더 저렴한걸로 바꾸려고	렌탈 계약 끝나서 더 저렴한 걸로 바꾸려고.
정제: 그래? 한달에 얼마정도 줬어?	그래? 한 달에 얼마 정도 줬어?
정제: 한달에 삼만원은 준거같아	한달에 삼만원은 주는 것 같아.
정제: 와~ 비싸긴 하다	와~ 비싸긴 하다.
정제: 이번에 얼음 나오는걸로 바꿀까 생각중이야	이번에 얼음 나오는 걸로 바꿀까 생각 중이야.
정제: 얼음 나오는거 좋아보이더라	얼음 나오는 거 좋아 보이더라.
정제: 마트아직 안갔지	마트 아직 안 갔지.
정제: 집에오면서 들릴거?	집에 오면서 들릴 거야?
정제: 응 왜	응, 왜?
정제: 뭐살거있어?	뭐 살 거 있어?
정제: 계란한판이랑	계란 한판이랑
정제: 사이다 큰거	사이다 큰 거
정제: 계란 엊그저께샀자나???	계란 엊그저께 샀잖아???
정제: 없어?	없어?
정제: 다먹었는뎅ㅋㅋㅋ계란말이하고 계란찜하고	다 먹었는데ㅋㅋㅋ 계란말이 하고 계란찜 하고.
정제: 금방 다먹던데? 2개남음	금방 다 먹던데? 2개 남음.
정제: 알앗어	알았어
정제: 내 목에 걸려잇는건데	내 목에 걸려 있는데
정제: 요즘 신상이라	요즘 신상이라.
정제: ㅇㅎ	아하
정제: 오케오케 ㅋㅋ	오케이 오케이 ㅋㅋ
정제: 아직 프로토타입만 잇을수도잇는데	아직 프로토타입만 있는 수도 있는데.
정제: 넌 다 줄듯	넌 다 줄듯.
정제: #@이름#이랑 주문하려고	#@이름#이랑 주문하려고.
정제: 나인거 말 안할건데?	나인 거 말 안 할 건데?
정제: 음	음
정제: 충주뜨면	충주 뜨면
정제: 백퍼알걸	100% 알 걸
정제: 너라고 말해야 챙겨줄수잇는거 더 끼워서 보내줄텐뎅	너라고 말해야 챙겨줄 수 있는 거 더 끼워서 보내줄 텐데.
정제: 그려??ㅎㅎ	그래??ㅎㅎ
정제: ㅋㅋㅋㅋㅋ	ㅋㅋㅋㅋㅋ
정제: 흠	흠
정제: ㅇㅋㅇㅋ	오케이 오케이
정제: 알겠어 ㅋ	알겠어 ㅋ
정제: 그칭	그치
정제: #@이름#이나 #@이름#한테 연락해바	#@이름#이나 #@이름#한테 연락해 봐.
정제: 주문은 대충 넣으면	주문은 대충 넣으면.
정제: #@이름#시	#@이름# 씨
정제: 토끼 곰돌이 어떤 것입니까	토끼 곰돌이 어떤 것입니까.
정제: 아 미친 방금 나도 케이스 질르고왔는뎈ㅋㅋㅋㅋㅋㅋㅋㅋㅋㅋㅋ	아 미친 방금 나도 케이스 지르고 왔는뎈ㅋㅋㅋㅋㅋㅋㅋㅋㅋㅋㅋ
정제: 곰돌이!!!!!	곰돌이!!!!!
정제: ㅋㅋㅋㅋㅋㅋㅋ 은근 케이스 자주 지르는 듯하다 너	ㅋㅋㅋㅋㅋㅋㅋ 은근히 케이스 자주 지르는 듯하다 너.
정제: 역시 곰돌이겠지? ㅠㅠ	역시 곰돌이겠지? ㅠㅠ
정제: 둘 다 넘 귀여워서 넘 고민이다	둘 다 너무 귀여워서 너무 고민이다.
정제: 나 쌩폰 들고다닌지 꽤 됐어	나 쌩폰 들고 다닌지 꽤 됐어.
정제: ㅋㅋㅋㅋㅋㅋ케이스 안지른지 삼백년됨..	ㅋㅋㅋㅋㅋㅋ 케이스 안 지른 지 삼백 년 됨..
정제: ㅋㅋㅋㅋㅋㅋ	ㅋㅋㅋㅋㅋㅋ
정제: ㅠ실리콘케이스 집에 몇개있는거 돌려쓰는게 다얀ㅠ	ㅠ 실리콘 케이스 집에 몇 개 있는 거 돌려쓰는 게 다야 ㅠ
정제: 가격 진짜 괜찮은데	가격 진짜 괜찮은데.
정제: 사기 못치게하는법은 없나	사기 못 치게 하는 법은 없나.
정제: 중고나라는 에스크로안됨?	중고나라는 에스크로 안 됨?
정제: 에스크로 어떤사이트가 좋지	에스크로 어떤 사이트가 좋지.
정제: 글삭했네	글 삭제했네.
정제: 사기꾼인갑다	사기꾼인가 보다.
정제: 진행 안해야겠다	진행 안 해야겠다.
정제: 중고나아사기꾼넘나많은것	중고나라 사기꾼 너무나 많은 것
정제: 대화중에	대화 중에
정제: 퍼뜩 생각나서 게시글 누르니까	퍼뜩 생각나서 게시글 누르니까
정제: 얘 로드자전거 매물볼때	얘 로드 자전거 매물 볼 때
정제: 뻘짓하는거 본거같다	뻘짓 하는 거 본 거 같다.
정제: 게시글도 없었음	게시글도 없었어
정제: #@이름#보고	#@이름# 보고
정제: 청주 40만 직거래 해오라케야겠다	청주 40만 직거래 해오라고 해야겠다.
정제: 그게맞다	그게 맞다.
정제: 거래는직거래지	거래는 직거래지.
정제: 편의점도직거래자나	편의점도 직거래잖아
정제: 그치	그치
정제: 아냐	아냐
정제: 편의점은	편의점은
정제: 직거래 아냐	직거래 아냐
정제: 눈 안마주치고 사고나옴	눈 안 마주치고 사고 나옴
정제: 사진도직찍이최고지	사진도 직접 찍는게 최고지.
정제: 중고나라도	중고 나라도
정제: 눈안마주칠수도있음	눈 안 마주 칠 수도 있음.
정제: 무섭다 그건	무섭다 그건
정제: 막 문신형아 나옴 어케	막 문신 형아 나옴 어떡해
정제: 차에서물건만유리창으로넘긴다고	차에서 물건만 유리창으로 넘긴다고
정제: 갠차나	괜찮아
정제: 뭔가 사달라는건 다 사줄거 같은 느낌이야ㅋㅋㅋ	뭔가 사달라는 건 다 사줄 거 같은 느낌이야ㅋㅋㅋ.
정제: #@이모티콘#	#@이모티콘#
정제: 어떻게 알았지...	어떻게 알았지...
정제: ㅋㅋㅋㅋㅋㅋㅋㅋㅋㅋㅋㅋㅋㅋㅋㅋㅋㅋㅋㅋㅋㅋㅋ	ㅋㅋㅋㅋㅋㅋㅋㅋㅋㅋㅋㅋㅋㅋㅋㅋㅋㅋㅋㅋㅋㅋㅋ
정제: 그럼 나 목걸이 본다아아아아아아	그럼 나 목걸이 본다아아아아아아.
정제: 응응!!!	응응!!!
정제: 이쁜거 골라!!	이쁜 거 골라!!
정제: 응응	응응
정제: 커피마시고 백화점가서 구경하고있을게!	커피 마시고 백화점 가서 구경하고 있을게!
정제: 그러네 근데 5마넌 9마넌에 산 사람들은	그러네, 근데 5만원 9만원에 산 사람들은
정제: 통신사 변경이더라	통신사 변경이더라.
정제: 기기변경은 싸도 15마넌 언저리인가봄	기기 변경은 싸도 15만원 언저리인가 봄.
정제: 그런가봐 그래도 엄마 안바꿀걸	그런가봐 그래도 엄마 안 바꿀 걸.
정제: 요금제때문에?	요금제 때문에?
정제: 엄마 접히는 폰 갖고 싶다고 했었는데 전에	엄마, 접히는 폰 갖고 싶다고 했었는데 전에.
정제: 응	응
정제: 내일 개통 되는가 함 가볼까?	내일 개통되는 지 한번 가볼까?
정제: 한솔애플타워네	한솔 애플 타워네
정제: 응 19만원이고	응 19만원이고.
정제: 요금제도 69네 전거는 더 비쌋지 아너?	요금제도 69네 전거는 더 비쌌지 않아?
정제: 그떄 83인가	그때 83인가.
정제: 그니까	그니까
정제: 내일 물어보자	내일 물어보자.
정제: ㅇㅋㅇㅋ	오케이 오케이
정제: 가방	가방
정제: 3월초까지 배송한다구했으면서	3월 초까지 배송한다고 했으면서
정제: 3월중순으로늘었어	3월 중순으로 늘었어.
정제: 으휴	으휴.
정제: 전화해봐라	전화 해봐라.
정제: 니가 주문한곳에	니가 주문한 곳에
정제: 전화해도 배송일은 똑같을거같애서	전화해도 배송일은 똑같을 거 같아서.
정제: 지금 환불할까말까 고민이지만	지금 환불할까 말까 고민이지만.
정제: 하지않겠어	하지 않겠어.
정제: 전번줘봐	전번 줘봐
정제: 환불해야지	환불 해야지
정제: 이게 뭐야	이게 뭐야.
정제: 왱?	왜?
정제: 환불원하면 환불은 바로 ㅎㅐ준대	환불 원하면 환불은 바로 해준대.
정제: 해야지	해야지.
정제: 그니까	그니까
정제: 그럼 또사지머..	그럼 또 사지 뭐..
정제: 선입금 기간을 기다려야 해여	선입금 기간을 기다려야 해요.
정제: ㅋㅋㅋㅋㅋ	ㅋㅋㅋㅋㅋ
정제: 천만이 봤으면	천만이 봤으면.
정제: 볼 사람은 다 봐서	볼 사람은 다 봐서.
정제: 이제 공개할거예옄ㅋㅋㅋㅋㅋㅋ	이제 공개할 거예요ㅋㅋㅋㅋㅋㅋㅋ
정제: 마자 이제	마자 이제
정제: 천만됫으니까	천만 됐으니까
정제: 올려주시오..	올려 주세요..
정제: 이제는 대부분 재관람이져	이제는 대부분 재관람이죠
정제: 근데 나름 전 뱃지가 예뻤던 사람들 도안은 더 공개된 거 같아	근데 나름 전 뱃지가 예뻤던 사람들 도안은 더 공개된 거 같아.
정제: 그래서 저 둘이.최선일 느띰	그래서 저 둘이 최선일 느낌.
정제: 훔	훔
정제: 일단 전 건틀렛 띰	일단 전 건틀렛 띠었어요.
정제: 어께이여	오케이요
정제: 새로운 거 나오면 알려주께	새로운 거 나오면 알려줄게.
정제: ㅋㅋ나더 종종 찾아봐야징	ㅋㅋ 나도 종종 찾아봐야지.
정제: 아 근데 나 샤워기 필터 사볼까 하다가	아 근데 나 샤워기 필터 사볼까 하다가
정제: 걍 싼 거 써봐도 된다고 해서 만원짜리찾았는데	그냥 싼 거 써봐도 된다고 해서 만원짜리 찾았는데.
정제: 결국에는 뭐여	결국에는 뭐야
정제: 아 근데 더클럽 그거에서 시켰는대	아 근데 더 클럽 그거에서 시켰는데.
정제: 칠천원 쿠폰줘서ㅔ그거도 받았다	칠천원 쿠폰 줘서, 그거도 받았다.
정제: 오 대박	오, 대박!
정제: ㅋㅋㅋㅋㅋ오천원 쿠폰도 받으면	ㅋㅋㅋㅋㅋ 오천원 쿠폰도 받으면.
정제: 나름 현명한 소비라고해줘	나름 현명한 소비라고 해줘.
정제: 굳굳	굳굳
정제: 근데 산게ㅡ모짤렐라치즈	근데 산 게 모짤렐라 치즈.
정제: 계란	계란
정제: 알찬소비	알찬 소비
정제: 물	물
정제: 얼음 잔얼음 그거 한봉지	얼음 잔 얼음 그거 한 봉지
정제: 샤인머스켓	샤인머스켓
정제: 물티슈	물티슈
정제: 김치만두	김치 만두
정제: 끗..	끝..
정제: 만두 쪄먹고	만두 쪄 먹고
정제: 만두 구워먹고	만두 구워 먹고
정제: 만두라면 먹고	만두라면 먹고.
정제: ㅋㅋㅋㅋㅋㅋㅋㅋㅋㅋㅋㅋㅋㅋㅋㅋㅋ	ㅋㅋㅋㅋㅋㅋㅋㅋㅋㅋㅋㅋㅋㅋㅋㅋㅋ
정제: 계란 구워먹고	계란 구워 먹고
정제: #@URL#	#@URL#
정제: 나도 살까?	나도 살까?
정제: ㅇㅇ 저거 계속가격올릴듯	ㅇㅇ 저거 계속 가격 올릴 듯.
정제: 넌능사셩	너는 사셔
정제: 근데 흰색이랑 그린밖에 없어 ㅠㅠ	근데 흰색이랑 그린 밖에 없어 ㅠㅠ
정제: 오오	오오
정제: ㅋㅋㄱㄱ	ㅋㅋ 고고
정제: 흰색사야짐ㅋㅋㄱ	흰색 사야지ㅋㅋㅋ
정제: ㅋㅋㅋㅋㅋㅋㅋㅋ 흰색 때 안 타겠짘ㅋㅋㅋㅋㅋㅋ	ㅋㅋㅋㅋㅋㅋㅋㅋ 흰색 때 안 타겠지ㅋㅋㅋㅋㅋㅋ
정제: 2시이전결제시 당일발송인데	2시 이전 결제 시 당일 발송인데.
정제: 2시에결제하면	2시에 결제하면
정제: 내일발송인걸까	내일 발송인 걸까.
정제: 이전에 포함해줘라	이전에 포함해 줘라.
정제: 이하도 포함이잔아 그 숫자 (억지	이하도 포함이잔아 그 숫자 (억지)
정제: 아니 내일	아니, 내일.
정제: 미만이라고해줬어야지(땡깡	미만이라고 해줬어야지 (땡깡).
정제: 근데 융통성 발휘할지도 몰라	근데 융통성 발휘할지도 몰라.
정제: 제발	제발.
정제: 나 저기서 십마넌썻다고 화장품에	나 저기서 십만원 썼다고 화장품에.
정제: 저나해서 무러바	전화해서 물어봐.
정제: 오늘 아래위 두껍게 보낸거같은데	오늘 아래 위 두껍게 보낸 거 같은데.
정제: 8세용까지 ㅇ나와서	8세 용까지 나와서
정제: 애들 바지사야되	애들 바지 사야 돼.
정제: ㅇㅇ 탑텐에서1+1에 삿는데	ㅇㅇ 탑텐에서 1+1에 샀는데
정제: 19900	19900
정제: 좋앗어	좋았어
정제: 바지?	바지?
정제: ㅇㅇ 면인데 시보리 짱짱하드라	ㅇㅇ 면인데 시보리 짱짱하드라.
정제: 오	오
정제: 이천인데	이천인데.
정제: 애기들 사이즈도 100은 잇지 않을까	애기들 사이즈도 100은 있지 않을까
정제: ㅋㅋㅋㅋㅋㅋㅋㅋㅋㅋㅋㅋㅋㅋㅋ	ㅋㅋㅋㅋㅋㅋㅋㅋㅋㅋㅋㅋㅋㅋㅋ
정제: 아 귀찮다	아, 귀찮다
정제: #@이름#가 110입어	#@이름# 가 110 입어.
정제: 유니클러 레깅스 조은대	유니클로 레깅스 좋은데
